加 더할	가
可 옳을	가
角 뿔	각
感 느낄	감
客 손님	객
格 격식	격
決 결단할	결
結 맺을	결
輕 가벼울	경
敬 공경할	경
界 지경	계
苦 괴로울	고
考 상고할	고
告 알릴	고
曲 굽을	곡
公 공변될	공
果 과실	과
過 지날	과
球 공	구
郡 고을	군
貴 귀할	귀
根 뿌리	근
級 등급	급
吉 길할	길
能 능할	능
堂 집	당
待 기다릴	대
德 덕	덕
圖 그림	도
度 법도	도
童 아이	동
動 움직일	동
落 떨어질	락
良 어질	량
歷 지낼	력
例 법식	례
禮 예도	례
路 길	로
勞 수고로울	로
綠 푸를	록
流 흐를	류
李 오얏	리
亡 망할	망
買 살	매
賣 팔	매
美 아름다울	미
朴 순박할	박 
反 돌이킬	반
發 필	발
法 법	법 
兵 군사	병
病 병	병
福 복	복
服 옷	복
奉 받들	봉
冰 얼음	빙
仕 벼슬할	사
思 생각	사
史 역사	사
使 하여금	사
算 셈	산
相 서로	상
席 자리	석
雪 눈	설
省 살필	성
洗 씻을	세
消 사라질	소
速 빠를	속
孫 손자	손
樹 나무	수
數 셈	수
宿 잠잘	숙
順 순할	순
術 재주	술
習 익힐	습
勝 이길	승
始 처음	시
式 법	식
臣 신하	신
實 열매	실
失 잃을	실
兒 아이	아
愛 사랑	애
野 들	야
藥 약	약
陽 볕	양
洋 큰바다	양
漁 고기잡을	어
億 억	억
業 일	업
如 같을	여
然 그럴	연
溫 따뜻할	온
要 구할	요
勇 날쌜	용
雲 구름	운
運 움직일	운
園 동산	원
院 집	원
油 기름	유
由 말미암을	유
飮 마실	음
醫 의원	의
以 써	이 
因 인할	인
任 맡길	임
者 놈	자
昨 어제	작
章 글	장
再 두	재
在 있을	재
材 재목	재
的 과녁	적
赤 붉을	적
典 법	전
戰 싸움	전
展 펼	전
庭 뜰	정
定 정할	정
題 제목	제
第 차례	제
族 겨레	족
卒 군사	졸
州 고을	주
注 물댈	주
止 그칠	지
知 알	지
紙 종이	지
集 모일	집
參 참여할	참
窓 창문	창
責 꾸짖을	책
淸 맑을	청
體 몸	체
初 처음	초
充 채울	충
特 특별할	특
表 겉	표
品 물건	품
風 바람	풍
必 반드시	필
河 물	하
幸 다행	행
現 나타날	현
號 이름	호
畫 그림	화
化 될,변화할	화
訓 가르칠	훈
凶 흉할	흉
黑 검을	흑
