袈 가사	가
稼 곡식심을	가
苛 매울	가
駕 멍에	가
嫁 시집갈	가
恪 삼갈	각
揀 가릴	간
侃 굳셀	간
澗 시내	간
玕 옥돌	간
喝 꾸짖을	갈
竭 다할	갈
碣 비(선돌게)	갈
柑 감귤	감
瞰 굽어볼	감
勘 헤아릴	감
匣 상자	갑
糠 겨	강
杠 깃대	강
堈 독,언덕	강
橿 박달나무	강
薑 생강	강
羌 종족이름	강
絳 진홍색	강
襁 포대기	강
芥 겨자	개
漑 물댈	개
疥 옴	개
愷 편안할	개
羹 국	갱
醵 잔치(추렴할거)	갹
遽 갑자기,급할	거
渠 도랑	거
鉅 클,갈고리	거
楗 문빗장	건
虔 정성스러울	건
愆 허물	건
杰 호걸	걸
怯 겁낼	겁
檄 격문	격
譴 꾸짖을	견
鵑 두견새	견
抉 도려낼,들추어낼	결
鎌 낫	겸
痙 경련	경
鯨 고래	경
俓 곧을	경
勁 굳셀,힘	경
倞 굳셀	경
逕 길	경
憬 깨달을	경
擎 높이들	경
梗 대개,막힐	경
檠 도지개	경
坰 들	경
耿 반짝거릴	경
暻 밝을	경
熲 빛날,불빛	경
冏 빛날,창	경
莖 줄기	경
涇 통할	경
誡 경계할,훈계할	계
稽 상고할	계
烓 화덕,밝을	계
敲 가로두드릴	고
股 넓적다리	고
睾 늪,불알	고
拷 때릴	고
叩 머리숙여두드릴	고
羔 새끼양	고
瞽 소경	고
鵠 고니,과녁	곡
轂 바퀴,수레	곡
鯤 곤이	곤
棍 몽둥이(묶을혼)	곤
崑 산이름	곤
琨 아름다운옥	곤
錕 적금	곤
控 당길	공
拱 두손맞잡을	공
鞏 묶을,굳을	공
珙 큰옥	공
廓 둘레,클	곽
藿 콩잎	곽
棺 널	관
灌 물댈	관
錧 비녀장,쟁기	관
瓘 옥	관
琯 피리	관
括 쌀	괄
匡 바룰	광
曠 밝을,넓을	광
桄 베틀	광
炚 비칠,밝을	광
侊 성할,클	광
胱 오줌통	광
珖 옥피리	광
洸 용솟음할,빛날	광
拐 속일	괴
魁 으뜸	괴
槐 홰나무	괴
虢 범발톱자국,나라이름	괵
宏 클	굉
肱 팔뚝	굉
喬 높을	교
嬌 아리따울	교
攪 어지러울	교
枸 구기자	구
銶 끌	구
柩 널	구
溝 도랑	구
垢 때	구
寇 떼도둑	구
駒 망아지	구
耈 명길	구
軀 몸	구
咎 허물	구
躬 몸	궁
蹶 넘어질	궐
潰 무너질	궤
詭 속일	궤
机 책상	궤
窺 엿볼	규
逵 큰길	규
葵 해바라기	규
畇 밭일굴	균
鈞 서른근	균
橘 귤	귤
剋 이길	극
戟 창	극
隙 틈	극
劤 강할	근
漌 맑을	근
墐 매흙질할	근
饉 흉년들	근
昑 밝을	금
衿 옷깃	금
襟 옷깃	금
衾 이불	금
扱 걷어가질,미칠	급
汲 물길을	급
亘 뻗칠	긍
錡 가마솥	기
璂 고깔꾸미개옥	기
杞 구기자	기
埼 굽은낭떠러지	기
妓 기생	기
祺 길할	기
譏 나무랄	기
綺 무늬비단	기
淇 물이름	기
暣 볕기운,날씨	기
崎 산길험할	기
圻 서울지경	기
磯 자갈,여울돌	기
伎 재주,광대	기
嗜 즐길	기
玘 패옥	기
錤 호미	기
佶 건장할,굽을	길
桔 도라지	길
姞 성,삼갈	길
喫 먹을	끽
懦 나약할	나
娜 아리따울	나
捺 누를	날
捏 반죽할	날
楠 녹나무,들메나무	남
湳 물이름	남
囊 주머니	낭
柰 능금나무,어찌	내
恬 편안할	념
佞 아첨할	녕
膿 고름	농
紐 맬	뉴
鈕 인꼭지	뉴
緞 비단	단
疸 황달	달
痰 가래	담
澹 물모양,담박할	담
覃 미칠,깊을	담
譚 이야기	담
曇 흐릴	담
沓 거듭	답
螳 사마귀	당
鐺 쇠사슬,북소리	당
撞 칠,두드릴	당
棠 팥배나무,아가위	당
玳 대모	대
岱 대산	대
擡 들	대
棹 노	도
堵 담	도
鍍 도금할	도
蹈 밟을,춤출	도
屠 잡을	도
搗 찧을	도
瀆 도랑	독
犢 송아지	독
墩 돈대	돈
焞 밝을	순
暾 아침해돋을	돈
憧 그리워할	동
瞳 눈동자	동
潼 물이름	동
疼 아플	동
垌 항아리	동
枓 물구기(주두두)	주
痘 천연두	두
遁 달아날,피할	둔
鄧 나라이름	등
騾 노새	라
螺 소라	라
珞 구슬목걸이	락
酪 유즙	락
烙 지질	락
瀾 큰물결	란
瓓 옥무늬	란
辣 매울	랄
襤 누더기	람
籃 바구니	람
臘 납향,섣달	랍
琅 옥이름	랑
狼 이리	랑
崍 산이름	래
輛 수레	량
倆 재주	량
黎 무리,검을	려
戾 어그러질	려
閭 이문,마을	려
靂 벼락	력
轢 삐걱거릴	력
攣 경련,걸릴	련
輦 손수레	련
漣 잔물결	련
璉 호련	련
洌 맑을	렬
冽 찰,맵게추울	렬
簾 발	렴
濂 시내이름	렴
鈴 방울	령
姈 여자영리할	령
伶 영리할,악관	령
怜 지혜로울	령
昤 햇빛영롱할	령
隷 종	례
撈 잡을	로
彔 나무새길	록
瀧 비올,여울	롱
瓏 옥소리,환할	롱
儡 꼭두각시,영락할	뢰
瞭 눈밝을	료
鬧 시끄러울	뇨
褸 남루할	루
陋 좁을,더러울	루
壘 진	루
琉 유리	류
硫 유황	류
戮 죽일	륙
侖 뭉치,둥글	륜
綸 벼리,낚시줄	륜
淪 빠질,잔물결	륜
崙 산이름	륜
慄 두려워할	률
肋 갈빗대	륵
凜 찰	름
凌 능가할	릉
菱 마름	릉
綾 비단	릉
莉 말리	리
离 밝을,산신	리
俚 속될	리
悧 영리할	리
籬 울타리	리
璃 유리	리
痢 이질	리
俐 지혜로울	리
潾 물맑을	린
璘 옥무늬	린
躪 짓밟을	린
淋 물뿌릴	림
琳 아름다운옥	림
霖 장마	림
笠 삿갓	립
瑪 마노	마
邈 멀	막
鏋 금	만
曼 길	만
挽 당길	만
蔓 덩굴	만
沫 거품	말
茉 말리꽃	말
邙 산이름	망
莽 우거질	망
邁 갈,힘쓸	매
煤 그을음	매
罵 욕할	매
萌 싹	맹
麵 국수	면
棉 목화	면
沔 물흘러가득할	면
溟 바다,이슬비	명
酩 술취할	명
冒 무릅쓸	모
摸 본뜰	모
歿 죽을	몰
猫 고양이	묘
錨 닻	묘
畝 밭이랑(묘)	무
憮 심심할	무
鵡 앵무새	무
撫 어루만질	무
拇 엄지손가락	무
珷 옥돌	무
懋 힘쓸,성할	무
炆 따뜻할	문
蚊 모기	문
紋 무늬	문
渼 물결무늬	미
靡 쓰러질	미
縻 얽어맬	미
薇 장미	미
敃 강할,힘쓸	민
忞 마음다잡을	민
岷 산이름	민
慜 총명할	민
鉑 금박	박
駁 논박할	박
撲 두드릴	박
璞 옥돌	박
珀 호박	박
頒 나눌,반포할	반
磐 너럭바위	반
畔 밭두둑	반
潑 물뿌릴	발
跋 밟을	발
勃 우쩍일어날	발
彷 거닐	방
坊 동네	방
昉 밝을	방
滂 비퍼부을	방
膀 오줌통,쌍배	방
陪 도울	배
湃 물결칠	배
徘 배회할	배
佰 일백,백사람	백
蕃 무성할	번
杋 나무이름	범
氾 넘칠	범
帆 돛	범
范 벌풀	범
璧 둥근옥	벽
霹 벼락	벽
闢 열	벽
輧 가벼운수레	병
餠 떡	병
甁 병,단지	병
棅 자루	병
鉼 판금,가마솥	병
潽 물넓을	보
菩 보살	보
堡 작은성	보
褓 포대기	보
鍑 아가리큰솥	복
馥 향기	복
棒 몽둥이	봉
捧 받들	봉
烽 봉화	봉
鋒 칼끝	봉
琫 칼집장식,옥	봉
俯 구부릴,숙일	부
溥 넓을	부
斧 도끼	부
孚 미쁠,참될	부
孵 알깔	부
芙 연꽃	부
腑 장부	부
糞 똥	분
雰 안개	분
汾 클,물굽이쳐흐를	분
鄙 더러울	비
庇 덮을	비
扉 문짝	비
緋 비단	비
枇 비파나무	비
琵 비파	비
泌 샘물흐를	비
痹 저릴	비
脾 지라	비
臂 팔	비
誹 헐뜯을	비
嬪 궁녀	빈
濱 물가	빈
斌 빛날	빈
牝 암컷	빈
憑 기댈	빙
裟 가사	사
紗 깁	사
肆 늘어놓을,방자할	사
獅 사자	사
瀉 쏟을	사
娑 춤출	사
珊 산호	산
薩 보살	살
杉 삼나무	삼
翔 날	상
塽 땅높고밝은곳	상
湘 물이름	상
爽 시원할	상
顙 이마	상
璽 옥새	새
穡 거둘	색
笙 생황	생
壻 사위	서
曙 새벽	서
嶼 섬	서
㥠 지혜	서
抒 풀,펼	서
鉐 놋쇠	석
䄷 섬	석
淅 쌀일	석
汐 저녁조수	석
嬋 고울	선
銑 무쇠	선
渲 바림,물적실	선
墡 백토	선
羨 부러워할	선
扇 부채	선
煽 불부칠	선
腺 샘	선
琁 옥	선
珗 옥돌	선
愃 쾌할	선
褻 더러울,속옷	설
泄 샐	설
楔 쐐기	설
渫 칠	설
殲 다죽일	섬
惺 깰	성
瑆 옥빛	성
珹 옥이름	성
遡 거슬러올라갈	소
搔 긁을	소
卲 높을	소
柖 나무흔들릴	소
炤 밝을	소
玿 아름다운옥	소
韶 아름다울	소
霄 하늘	소
嘯 휘파람불	소
巽 괘이름,유순할	손
飱 저녁밥	손
淞 물이름	송
灑 뿌릴	쇄
釗 힘쓸,쇠	쇠
髓 골수	수
隧 길	수
狩 사냥	수
岫 산굴	수
竪 세울	수
袖 소매	수
琇 옥돌	수
讐 원수	수
穗 이삭	수
綬 인끈	수
瘦 파리할	수
綏 편안할	수
嫂 형수	수
橚 나무줄지어설	숙
俶 비롯할	숙
璹 옥그릇	숙
琡 옥이름	숙
夙 일찍	숙
馴 길들일	순
詢 물을	순
錞 사발종	순
醇 순후할	순
諄 타이를	순
嵩 높을,산이름	숭
膝 무릎	슬
璱 푸른진주	슬
陞 오를	승
丞 정승	승
柹 감나무	시
恃 믿을	시
熄 꺼질	식
拭 닦을	식
寔 이	식
栻 점판	식
埴 찰흙	식
薪 땔나무	신
訊 물을	신
莘 족도리풀	신
悉 다	실
沁 스며들	심
什 열	십
衙 마을	아
訝 맞을,의심할	아
峨 산높을	아
娥 예쁠	아
愕 놀랄	악
堊 흰흙	악
軋 삐걱거릴	알
闇 닫힌문,어두울	암
菴 초막	암
昻 높을	앙
鴦 원앙새	앙
曖 가릴,흐릴	애
崖 낭떠러지	애
厓 언덕	애
腋 겨드랑이	액
鶯 꾀꼬리	앵
櫻 앵두나무	앵
鸚 앵무새	앵
冶 불릴	야
爺 아비	야
驤 머리들,달릴	양
攘 물리칠	양
瘍 종기	양
漾 출렁거릴	양
馭 부릴	어
飫 포식할,물릴	어
檍 참죽나무	억
諺 상말,속담	언
掩 가릴	엄
俺 나	엄
奄 문득	엄
嶪 산높을	업
晹 날흐릴	역
沇 강이름	연
筵 대자리	연
涓 물흐를,가릴	연
娟 예쁠	연
讌 잔치,모여이야기할	연
艶 고울	염 
琰 옥,홀	염
曄 빛날	엽
纓 갓끈	영
渶 강이름	영
楹 기둥	영
塋 무덤	영
瀯 물흐를	영
鍈 방울소리	영
煐 사람이름,빛날	영
嬰 어릴	영
瓔 옥돌	영
穎 이삭,빼어날	영
曳 끌	예
乂 다스릴,벨	예
叡 밝을	예
刈 벨,자를	예
翳 일산,가릴	예
裔 후손	예
旿 낮밝을,대낮	오
晤 밝을,만날	오
奧 속,깊을	오
珸 옥돌	오
寤 잠깰	오
瑥 사람이름	온
穩 평온할	온
媼 할미	온
壅 막힐	옹
渦 소용돌이	와
翫 가지고놀	완
阮 관이름,성	완
梡 도마,장작	완
琬 아름다운옥	완
婉 아름다울	완
浣 옷빨	완
玩 장난할,놀	완
垸 칠에회바를	완
腕 팔	완
枉 굽을	왕
猥 함부로	외
窈 그윽할	요
窯 기와굽는가마,도기	요
饒 넉넉할	요
僥 바랄	요
寥 쓸쓸할	료
颻 불어오르는바람	요
瑤 아름다운옥	요
擾 어지러울	요
凹 오목할	요
埇 길돋을	용
墉 담	용
湧 물솟아날	용
蓉 부용	용
榕 용나무	용
迂 멀	우
隅 모퉁이	우
堣 산모퉁이	우
釪 악기이름,바리때	우
玗 옥돌	우
瑀 패옥	우
虞 헤아릴	우
彧 문채	욱
耘 김맬	운
沄 소용돌이칠	운
殞 죽을	운
澐 큰물결	운
沅 강이름	원
轅 끌채	원
垣 담	원
愿 삼갈	원
洹 세차게흐를	원
嫄 여자이름	원
猿 원숭이	원
鴛 원앙	원
寃 원통할	원
煒 붉은빛	위
瑋 진귀할	위
暐 햇빛	위
輶 가벼울	유
洧 강이름	유
侑 권할	유
諭 깨우칠	유
猷 꾀할	유
秞 무성할	유
攸 바	유
蹂 밟을	유
瑜 아름다운옥	유
宥 용서할	유
柚 유자	유
臾 잠깐	유
帷 장막	유
孺 젖먹이	유
濡 젖을	유
愉 즐거울	유
游 헤엄칠	유
堉 기름진땅	육
玧 귀막는옥	윤
阭 높을	윤
奫 물깊고넓을	윤
戎 병기,되	융
膺 가슴	응
毅 굳셀	의
懿 아름다울	의
誼 옳을	의
椅 의자	의
倚 의지할	의
擬 헤아릴,비길	의
邇 가까울	이
貽 끼칠	이
爾 너	이
弛 늦출	이
彞 떳떳할	이
頤 턱,기를	이
瀷 스며흐를,물이름	익
謚 웃을	익
溢 넘칠	일
馹 역말	일
稔 곡식익을	임
剩 남을	잉
孕 아이밸	잉
仍 인할,거듭	잉
藉 깔개	자
咨 물을,탄식할	자
煮 삶을	자
瓷 오지그릇	자
仔 자세할	자
鵲 까치	작
灼 사를,구울	작
芍 작약	작
炸 터질	작
箴 바늘,경계할	잠
漳 강이름	장
暲 밝을	장
薔 장미	장
奘 클	장
梓 가래나무	재
縡 일	재
齋 재계할	재
錚 쇳소리	쟁
楮 닥나무	저
沮 막을	저
躇 머뭇거릴	저
咀 씹을	저
邸 집	저
迪 나아갈	적
嫡 정실	적
廛 가게	전
剪 가위	전
琠 귀막이옥	전
瑱 귀막이옥	진
栓 나무못	전
塡 메울	전
詮 설명할	전
佺 신선이름	전
銓 저울,전형할	전
奠 제사지낼,정할	전
牋 편지	전
荃 향풀	전
晢 밝을	절
粘 끈끈할	점
湞 강이름	정
幀 그림족자	정
柾 나무결바를	정
鋥 날번뜩일	정
靚 단장할	정
碇 닻	정
釘 못	정
町 밭두둑	정
炡 빛날	정
挺 뺄	정
鋌 쇳덩이,살촉	정
酊 술취할	정
錠 신선로,덩이	정
淀 얕을물	정
姃 여자단정할	정
玎 옥소리	정
綎 인끈	정
鉦 징	정
桯 탁자	정
珵 패옥	정
靖 편안할	정
晸 해뜰	정
蹄 굽	제
梯 사닥다리	제
瑅 옥이름	제
詔 고할	조
棗 대추나무	조
俎 도마	조
遭 만날	조
槽 말구유	조
眺 바라볼	조
嘲 비웃을	조
凋 시들	조
肇 시작할	조
窕 정숙할	조
糟 지게미	조
淙 물소리	종
踪 발자취	종
腫 부스럼	종
倧 상고신인	종
鍾 술잔	종
棕 종려나무	종
悰 즐거울	종
遒 굳셀	주
澍 단비,적실	주
躊 머뭇거릴	주
輳 모일,바퀴살통	주
湊 모일,항구	주
誅 벨	주
嗾 부추길	주
炷 심지	주
妵 예쁠	주
呪 저주할	주
紂 주임금	주
胄 투구	주
埻 과녁	준
畯 농부	준
竣 마칠	준
隼 새매	준
雋 새살찔	전
儁 준걸	준
焌 태울	준
茁 싹틀(촬)	줄
櫛 빗	즐
楫 노	집
汁 진액	즙
烝 김오를,무리	증
祗 공경할	지
咫 길이	지
沚 물가	지
趾 발가락	지
鋕 새길	지
摯 잡을,지극할	지
賑 기민먹일	진
禛 복받을	진
縝 삼실,촘촘할	진
軫 수레뒤턱나무	진
瑨 아름다운옥돌	진
跌 넘어질	질
瓆 사람이름	질
嫉 시기할	질
潗 샘솟을	집
澄 맑을	징
磋 갈	차
蹉 넘어질	차
瑳 옥빛깨끗할	차
撰 글지을	찬
澯 맑을	찬
纂 모을	찬
纘 이을	찬
粲 정미	찬
擦 비빌	찰
塹 구덩이	참
懺 뉘우칠	참
讒 참소할	참
瘡 부스럼	창
愴 슬퍼할	창
菖 창포	창
廠 헛간	창
寀 녹봉	채
綵 채색비단	채
凄 쓸쓸할	처
脊 등성마루	척
剔 뼈바를	척
滌 씻을	척
坧 터	척
瘠 파리할	척
阡 밭두둑	천
仟 일천,천사람	천
轍 바퀴자국	철
凸 볼록할	철
綴 철할	철
僉 다	첨
諂 아첨할	첨
籤 제비	첨
帖 문서	첩
牒 서찰	첩
諦 살필	체
誚 꾸짖을	초
樵 나무할	초
蕉 파초	초
塚 무덤	총
楸 가래나무	추
墜 떨어질	추
錐 송곳	추
錘 저울추	추
樞 지도리	추
賰 부유할	춘
瑃 옥이름	춘
珫 귀고리	충
萃 모을	췌
脆 연할	취
娶 장가들	취
翠 푸를	취
馳 달릴	치
熾 불활활탈	치
癡 어리석을	치
琛 보배	침
蟄 겨울잠잘	칩
秤 저울	칭
夬 나눌	쾌
惰 게으를	타
咤 꾸짖을	타
垞 언덕	택
唾 침	타
晫 밝을	탁
擢 뽑을	탁
琸 사람이름	탁
倬 클	탁
憚 꺼릴	탄
嘆 탄식할	탄
坦 평탄할	탄
耽 즐길	탐
搭 탈	탑
蕩 쓸어버릴	탕
邰 나라이름	태
跆 밟을	태
苔 이끼	태
汰 일,씻을	태
撐 버틸	탱
筒 대통  	통
桶 통	통
堆 쌓을	퇴
套 덮개	투
妬 투기할	투
巴 땅이름	파
杷 비파나무	파
琶 비파	파
芭 파초	파
婆 할미	파
坂 고개	판
沛 늪	패
浿 물이름	패
佩 찰	패
澎 물부딪는소리	팽
烹 삶을	팽
堭 당집	황
枰 바둑판	평
陛 섬돌	폐
褒 기릴	포
泡 물거품	포
庖 부엌	포
輻 바퀴살통	폭
瀑 폭포	폭
驃 날랠	표
彪 범	표
飄 회오리바람	표
稟 줄,천품	품
諷 욀	풍
披 헤칠	피
佖 점잖을	필
鉍 창자루	필
珌 칼집장식옥	필
苾 향기날	필
馝 향기로울	필
娍 아름다울,헌걸찰	성
逼 닥칠	핍
霞 놀	하
遐 멀	하
蝦 새우	하
廈 큰집	하
壑 골,구렁	학
謔 희롱거릴	학
澣 빨래	한
閒 한가할	한
緘 봉할	함
涵 젖을	함
鹹 짤	함
姮 항아	항
駭 놀랄	해
邂 만날	해
偕 함께	해
楷 해서	해
諧 화할,농담	해
倖 요행	행
婠 품성좋을	완
饗 잔치할	향
珦 향옥	향
墟 터	허
奕 클	혁
泫 물깊고넓을	현
眩 아찔할	현
玹 옥돌,옥빛	현
晛 햇살	현
挾 낄	협
浹 두루미칠	협
俠 호협할	협
荊 가시나무	형
熒 등불반짝일,미혹할	형
泂 멀	형
珩 패옥	형
蕙 난초	혜
彗 비,혜성	혜
譿 슬기로울,살필	혜
頀 구할,탕나라풍류	호
淏 맑을	호
灝 물넓고멀	호
壺 병	호
瑚 산호	호
狐 여우	호
顥 클,흴	호
糊 풀	호
琥 호박	호
弧 활	호
濩 흘러퍼질	호
渾 흐릴	혼
惚 황홀할	홀
鉷 돌쇠뇌	홍
虹 무지개	홍
烘 화톳불	홍
嬅 여자이름	화
樺 자작나무	화
驩 기뻐할	환
喚 부를	환
奐 빛날,클	환
鐶 쇠고리	환
晥 환할	환
渙 흘러흩어질	환
紈 흰비단	환
闊 넓을	활
惶 두려워할	황
璜 반달옥	황
徨 방황할	황
煌 빛날	황
簧 생황	황
媓 어머니	황
榥 책상	황
恍 황홀할	황
誨 가르칠	회
繪 그림	회
晦 그믐	회
恢 넓을,클	회
檜 노송나무	회
徊 배회할	회
澮 봇도랑	회
鐄 큰종	횡
斅 가르칠	효
涍 강이름	효
驍 날랠	효
嚆 울릴	효
逅 만날	후
鑂 금빛바랠	훈
燻 불기운	훈
焄 연기에그을릴,향내	훈
暄 따뜻할	훤
喧 시끄러울	훤
萱 원추리	훤
彙 무리	휘
暉 빛	휘
虧 이지러질	휴
譎 속일	휼
欣 기뻐할	흔
昕 아침	흔
炘 화끈거릴	흔
屹 산우뚝솟을	흘
洽 윤택하게할,젖을	흡
翕 합할,모일	흡
恰 흡사할	흡
晞 마를	희
爔 불빛	희
僖 즐거울	희
曦 햇빛	희
凞 화할	희
詰 힐난할	힐
憓 사랑할	혜
嵇 산이름	혜