肝 간	간
諫 간할	간
懇 정성,간절할	간
幹 줄기	간
葛 칡	갈
憾 한할	감
剛 굳셀	강
慨 슬퍼할	개
坑 구덩이	갱
乞 빌	걸
揭 높이들	게
隔 막힐	격
牽 끌	견
絹 비단	견
肩 어깨	견
訣 이별할,비결	결
謙 겸손할	겸
炅 빛날	경
頃 이랑,잠깐	경
徑 지름길	경
桂 계수나무	계
繫 얽어맬	계
顧 돌아볼	고
鼓 북	고
雇 품팔이	고
哭 울	곡
菓 과자,과실	과
誇 자랑할	과
寡 적을	과
郭 성곽	곽
寬 너그러울	관
館 집,객사	관
狂 미칠	광
掛 걸	괘
卦 점괘	괘
傀 꼭두각시	괴
愧 부끄러울	괴
塊 흙덩이	괴
僑 객지에살	교
狡 교활할	교
絞 목맬	교
膠 아교	교
鷗 갈매기	구
狗 개	구
懼 두려울	구
驅 몰	구
購 살	구
丘 언덕	구
歐 토할	구
俱 함께	구
菊 국화	국
窟 굴 	굴
圈 둘레	권
厥 그	궐
闕 집	궐
軌 굴대	궤
叫 부르짖을	규
糾 살필	규
閨 안방	규
僅 겨우	근
槿 무궁화	근
肯 즐길	긍
忌 꺼릴	기
騎 말탈	기
棄 버릴	기
豈 어찌	기
飢 주릴	기
那 어찌	나
奈 어찌	내
惱 괴로워할	뇌
尿 오줌	뇨
尼 여승	니
泥 진흙	니
匿 숨을	닉
鍛 단련할	단
旦 아침	단
潭 못	담
膽 쓸개	담
踏 밟을	답
唐 당나라	당
戴 일	대
垈 터	대
渡 건널	도
挑 돋울	도
塗 바를,진흙	도
桃 복숭아	도
悼 슬퍼할	도
陶 질그릇	도
篤 도타울	독
棟 마룻대	동
凍 얼	동
桐 오동나무	동
屯 모일	둔
藤 등나무	등
謄 베낄	등
騰 오를	등
洛 강이름	락
欄 난간	란
爛 빛날	란
濫 넘칠	람
廊 행랑	랑
掠 노략질할	략
梁 들보	량
諒 살필,믿을	량
曆 책력	력
煉 달굴	련
廉 청렴할	렴
獵 사냥할	렵
齡 나이	령
靈 신령	령
虜 사로잡을	로
爐 화로	로
祿 녹	록
籠 새장	롱
賴 힘입을	뢰
僚 동료	료
療 병고칠	료
淚 눈물	루
漏 샐	루
屢 자주	루
謬 그릇될	류
隆 높을	륭
磨 갈	마
魔 마귀	마
摩 문지를	마
漠 사막	막
幕 장막,군막	막
慢 거만할	만
灣 물굽이	만
漫 물질펀할	만
蠻 오랑캐	만
娩 해산할	만
網 그물	망
茫 망망할	망
罔 없을	망
枚 낱,줄기	매
埋 묻을	매
媒 중매	매
猛 사나울	맹
綿 솜	면
滅 멸망할	멸
蔑 업신여길	멸
侮 업신여길	모
沒 빠질	몰
霧 안개	무
紊 어지러울	문
眉 눈썹	미
憫 불쌍히여길	민
蜜 꿀	밀
泊 배댈	박
舶 큰배	박
迫 핍박할	박
叛 배반할	반
盤 소반	반
搬 운반할	반
伴 짝	반
拔 뺄	발
傍 곁	방
紡 길쌈	방
倣 본받을	방
俳 광대	배
賠 배상할	배
魄 넋	백
伯 맏	백
柏 잣나무	백
飜 뒤칠,나부낄	번
煩 번거로울	번
閥 문벌	벌
碧 푸를	벽
僻 후미질	벽
屛 병풍	병
倂 아우를	병
覆 덮을	복
縫 꿰맬	봉
俸 녹,봉급	봉
蜂 벌	봉
封 봉할	봉
鳳 봉황새	봉
賦 구실	부
赴 다다를	부
簿 문서	부
符 부신	부
附 붙을	부
膚 살갗	부
腐 썩을	부
墳 무덤	분
崩 무너질	붕
匪 도둑	비
頻 자주	빈
聘 부를	빙
邪 간사할	사
似 같을	사
飼 먹일	사
沙 모래	사
蛇 뱀	사
唆 부추길	사
斜 비낄	사
赦 용서할	사
酸 실	산
傘 우산	산
蔘 삼	삼
揷 꽂을	삽
嘗 맛볼	상
桑 뽕나무	상
箱 상자	상
詳 자세할	상
裳 치마	상
塞 변방	새
誓 맹세할    (세)서
瑞 상서로울	서
緖 실마리	서
敍 차례,서술할	서
碩 클	석
禪 고요할	선
旋 돌	선
纖 가늘	섬
攝 끌어잡을	섭
貰 세낼	세
蘇 깨어날	소
召 부를	소
燒 불사를	소
騷 시끄러울	소
紹 이을	소
疏 트일,성길	소
粟 조	속
遜 겸손할	손
鎖 쇠사슬	쇄
垂 드리울	수
隨 따를	수
洙 물이름	수
睡 졸	수
獸 짐승	수
搜 찾을	수
孰 누구	숙
瞬 눈깜짝할	순
循 돌,좇을	순
殉 따라죽을	순
舜 순임금	순
脣 입술	순
升 되	승
昇 오를	승
僧 중	승
屍 주검	시
殖 번식할	식
晨 새벽	신
腎 콩팥	신
紳 큰띠	신
伸 펼	신
尋 찾을	심
芽 싹	아
阿 언덕	아
握 잡을	악
岳 큰산	악
雁 기러기	안
晏 늦을	안
按 살필	안
鞍 안장	안
謁 뵐,아뢸	알
癌 암	암
押 누를,수결	압
殃 재앙	앙
碍 막을	애
厄 재앙	액
耶 어조사	야
惹 이끌	야
孃 아가씨	양
御 어거할	어
抑 누를	억
焉 어조사	언
予 나,줄	여
譯 번역할	역
疫 염병	역
軟 연할	연
燕 제비	연
閱 볼,검열할	열
厭 싫을	염
影 그림자	영
詠 읊을	영
譽 기릴	예
預 미리,맡길	예
傲 거만할	오
梧 오동나무	오
娛 즐거워할	오
嗚 탄식할	오
獄 옥	옥
翁 늙은이	옹
緩 느릴	완
歪 비뚤   (외)왜
畏 두려울	외
妖 요망할	요
堯 요임금	요
腰 허리	요
搖 흔들	요
鎔 녹일	용
庸 떳떳할	용
傭 품팔이	용
偶 짝	우
禹 하우씨	우
韻 운,운치	운
鬱 답답할	울
苑 나라동산	원
僞 거짓	위
尉 벼슬이름	위
緯 씨줄	위
違 어긋날	위
謂 이를	위
幽 그윽할	유
愈 더욱,나을	유
惟 생각할	유
尹 다스릴	윤
閏 윤달	윤
潤 윤택할	윤
融 녹을,화할	융
淫 음란할	음
凝 엉길	응
伊 저	이
夷 클	이
翼 날개	익
姙 아이밸	임
諮 물을	자
恣 방자할	자
玆 이	자
磁 자석	자
紫 자줏빛	자
刺 찌를	자
酌 따를,술잔	작
爵 벼슬	작
蠶 누에	잠
暫 잠깐	잠
藏 감출	장
粧 단장할	장
墻 담	장
掌 손바닥	장
葬 장사지낼	장
莊 장엄할	장
載 실을	재
裁 옷마를	재
宰 재상	재
寂 고요할	적
摘 딸	적
滴 물방울	적
笛 피리	적
殿 대궐,큰집	전
竊 훔칠	절
漸 점차	점
蝶 나비	접
艇 거룻배	정
偵 정탐할	정
穽 함정	정
劑 약지을	제
釣 낚시	조
措 둘	조
燥 마를	조
彫 새길	조
縱 세로	종
珠 구슬	주
駐 머무를	주
洲 물가	주
鑄 부어만들	주
奏 아뢸	주
仲 버금	중
憎 미워할	증
贈 줄	증
蒸 찔	증
遲 더딜	지
旨 뜻	지
脂 비계	지
津 나루	진
振 떨칠	진
震 진동할,벼락	진
診 진찰할	진
塵 티끌	진
疾 병	질
輯 모을	집
徵 부를	징
懲 징계할	징
遮 막을	차
捉 잡을	착
刹 절	찰
札 편지,패	찰
斬 벨	참
慙 부끄러워할	참
慘 참혹할	참
彰 밝을	창
滄 큰바다	창
蒼 푸를	창
暢 화창할	창
彩 채색	채
悽 슬플	처
斥 물리칠	척
遷 옮길	천
薦 천거할	천
撤 거둘	철
徹 통할	철
諜 염탐할	첩
遞 갈마들	체
滯 막힐	체
締 맺을	체
逮 미칠	체
肖 닮을	초
哨 망볼	초
抄 베낄,노략질할	초
焦 탈	초
觸 닿을	촉
燭 촛불	촉
寵 사랑	총
催 재촉할	최
趨 달릴	추
抽 뽑을	추
醜 추할	추
軸 굴대	축
逐 쫓을	축
蹴 찰	축
衷 정성	충
衝 찌를,부딪칠	충
臭 냄새	취
炊 불땔	취
漆 옻칠할	칠
枕 베개	침
墮 떨어질	타
托 맡길,밀	탁
託 부탁할	탁
琢 쪼을	탁
誕 낳을	탄
胎 아이밸	태
殆 위태할	태
颱 태풍	태
頗 자못	파
把 잡을	파
罷 파할,마칠	파
覇 으뜸	패
遍 두루	편
偏 치우칠	편
坪 들,평수	평
蔽 덮을	폐
幣 폐백	폐
廢 폐할,버릴	폐
弊 해질	폐
抛 던질	포
怖 두려울	포
飽 배부를	포
漂 뜰	표
豹 표범	표
虐 사나울	학
鶴 학	학
旱 가물	한
翰 글,날개	한
汗 땀	한
含 머금을	함
陷 빠질	함
艦 싸움배	함
該 그,갖출	해
奚 어찌	해
軒 처마,수레	헌
玄 검을	현
縣 고을	현
懸 매달	현
穴 구멍	혈
嫌 싫어할	혐
峽 골짜기	협
脅 위협할,갈비대	협
螢 반딧불	형
衡 저울	형
型 틀,본보기	형
兮 어조사	혜
慧 지혜	혜
毫 가는털	호
浩 넓을	호
互 서로	호
胡 오랑캐	호
豪 호걸	호
酷 독할	혹
惑 미혹할	혹
魂 넋	혼
忽 갑자기	홀
鴻 기러기	홍
洪 넓을	홍
靴 가죽신	화
穫 거둘	확
還 돌아올	환
幻 허깨비	환
滑 미끄러울	활
荒 거칠	황
凰 봉황새	황
廻 돌아올	회
懷 품을	회
獲 사로잡을	획
橫 가로	횡
曉 새벽	효
喉 목구멍	후
侯 제후	후
勳 공	훈
毁 헐	훼
輝 빛날 	휘
携 끌	휴
痕 흉터	흔
稀 드물	희
熙 빛날	희
噫 탄식할	희
戲 희롱할	희