歌 노래	가
家 집	가
各 각각	각
間 사이	간
强 강할	강
開 열	개
去 갈	거
見 볼	견
京 서울	경
計 셀	계
高 높을	고
功 공	공
空 빌	공
共 함께	공
科 과목	과
光 빛	광
敎 가르칠	교
交 사귈	교
校 학교	교
區 나눌	구
國 나라	국
軍 군사	군
近 가까울	근
急 급할	급
旗 기	기
記 기록할	기
氣 기운	기
農 농사	농
多 많을	다
短 짧을	단
答 대답	답
當 마땅할	당
對 대답할	대
代 대신할	대
道 길	도
刀 칼	도
讀 읽을	독
冬 겨울	동
洞 고을	동
頭 머리	두
等 무리	등
登 오를	등
樂 즐거울	락
來 올	래
老 늙을	로
理 다스릴	리
里 마을	리
利 이로울	리
萬 일만	만
每 매양	매
面 낯	면
命 목숨	명
明 밝을	명
毛 털	모
無 없을	무
聞 들을	문
問 물을	문
物 물건	물
米 쌀	미
民 백성	민
班 나눌	반
半 절반	반
放 놓을	방
番 차례	번
別 다를	별
步 걸음	보
部 거느릴	부
分 나눌	분
社 모일	사
事 일	사
死 죽을	사
色 빛	색
書 글	서
線 줄	선
性 성품	성
成 이룰	성
所 바	소
首 머리	수
詩 글	시
時 때	시
示 보일	시
市 저자	시
植 심을	식
神 귀신	신
身 몸	신
信 믿을	신
新 새로울	신
室 집	실
安 편안할	안
夜 밤	야
弱 약할	약
語 말씀	어
言 말씀	언
永 길	영
英 꽃부리	영
午 낮	오
用 쓸	용
友 벗	우
遠 멀	원
原 언덕,근본	원
元 으뜸	원
有 있을	유
肉 고기	육
育 기를	육
銀 은	은
音 소리	음
邑 고을	읍
意 뜻	의
作 지을	작
長 긴	장
場 마당	장
才 재주	재
田 밭	전
電 번개	전
前 앞	전
全 온전할	전
朝 아침	조
祖 할아비	조
晝 낮	주
住 살	주
竹 대	죽
重 무거울	중
直 곧을	직
草 풀	초
村 마을	촌
秋 가을	추
春 봄	춘
親 친할	친
太 클	태
通 통할	통
貝 조개	패
便 편할	편
平 평평할	평
夏 여름	하
學 배울	학
韓 나라이름	한
漢 한수	한
合 합할	합
海 바다	해
行 다닐	행
血 피	혈
形 모양	형
花 꽃	화
話 말씀	화
和 화할,화목할	화
活 살	활
黃 누를	황
會 모일	회
孝 효도	효
後 뒤	후