犬 개	견
己 몸	기
林 수풀	림
馬 말	마
名 이름	명
百 일백	백
生 날	생
石 돌	석
先 먼저	선
姓 성씨	성
心 마음	심
羊 양	양
魚 물고기	어
玉 구슬	옥
牛 소	우
耳 귀	이
地 땅	지
川 내	천
千 일천	천
天 하늘	천