江 강	강
口 입	구
內 안	내
年 해	년
大 큰	대
目 눈	목
白 흰	백
山 메(뫼)	산
上 위	상
小 작을	소
手 손	수
外 바깥	외
右 오른	우
入 들	입
足 발	족
左 왼	좌
中 가운데	중
靑 푸를	청
出 날	출
下 아래	하