九 아홉	구
金 쇠	금
南 남녘	남
男 사내	남
女 여자	녀
東 동녘	동
六 여섯	륙
母 어머니	모
木 나무	목
門 문	문
父 아버지	부
北 북녘	북
四 넉	사
三 석	삼
西 서녘	서
水 물	수
十 열	십
五 다섯	오
月 달	월
二 두	이
人 사람	인
日 날	일
一 한	일
子 아들	자
弟 아우	제
七 일곱	칠
土 흙	토
八 여덟	팔
兄 맏	형
火 불	화