柯 가지	가
軻 굴대,사람이름	가
迦 부처이름,막을	가
賈 성(장사고)	가
嘉 아름다울	가
伽 절	가
殼 껍질	각
珏 쌍옥	각
艮 머무를	간
杆 몽둥이	간
墾 밭갈	간
奸 범할,간사할	간
艱 어려울	간
竿 장대	간
鞨 종족이름	갈
堪 견딜	감
邯 사람이름	감
鉀 갑옷	갑
岬 산허리	갑
慷 강개할	강
彊 굳셀,활셀	강
腔 빈속	강
姜 성	강
岡 언덕	강
疆 지경	강
凱 개선할,즐길	개
箇 낱	개
塏 높고건조한땅	개
价 클,착할	개
鍵 열쇠	건
桀 하왕이름,홰	걸
劫 위협할	겁
甄 질그릇구울	견
儆 경계할	경
瓊 붉을옥	경
璟 옥빛	경
屆 이를,극진할	계
痼 고질	고
膏 기름	고
皐 언덕	고
昆 맏	곤
串 곶	곶
款 정성,조목	관
驕 교만할	교
矩 곡척	구
邱 땅이름,언덕	구
毆 때릴	구
灸 뜸	구
鳩 비둘기	구
舅 시아버지	구
玖 옥돌	구
仇 원수	구
鞠 기를	국
掘 팔	굴
倦 게으를	권
眷 돌아볼	권
奎 별이름	규
珪 서옥	규
揆 헤아릴	규
圭 홀	규
棘 가시	극
瑾 구슬	근
兢 삼갈	긍
矜 자랑할	긍
岐 갈림길	기
璣 구슬,별이름	기
麒 기린	기
耆 늙을	기
沂 물이름,산이름	기
棋 바둑	기
冀 바랄	기
琪 옥	기
琦 옥이름	기
騏 준마	기
驥 천리마	기
箕 키	기
拏 붙잡을	나
溺 빠질	닉
湍 급한여울	단
撻 매질할	달
遝 뒤섞일	답
塘 못	당
袋 자루	대
燾 비출,덮을	도
濤 큰물결	도
萄 포도	도
惇 도타울,힘쓸	돈
燉 불빛성할	돈
頓 조아릴	돈
乭 돌	돌
董 동독할	동
杜 막을	두
懶 게으를	라
裸 벌거벗을	라
剌 어그러질	랄
拉 꺾을,끌고갈	랍
萊 명아주	래
亮 밝을	량
驪 검은말	려
礪 숫돌	려
廬 오두막집	려
呂 음률,등뼈	려
侶 짝	려
斂 거둘	렴
玲 옥소리	령
醴 단술	례
蘆 갈대	로
魯 노나라	로
盧 목로,검을	로
鷺 백로	로
聾 귀먹을	롱
賂 뇌물줄	뢰
遼 멀	료
劉 성	류
楞 모	릉
麟 기린	린
鱗 비늘	린
吝 아낄	린
粒 낟알	립
痲 저릴,홍역	마
寞 고요할	막
膜 흘떼기,막	막
瞞 속일	만
靺 종족이름	말
魅 도깨비,홀릴	매
昧 어두울	매
寐 잠잘	매
貊 종족이름	맥
覓 찾을	멱
冕 면류관	면
俛 힘쓸,굽힐	면
謨 꾀	모
茅 띠	모
帽 모자	모
牡 수컷	모
耗 줄을	모
牟 클,소울	모
穆 화목할	목
描 그릴	묘
昴 별이름	묘
毋 말	무
巫 무당	무
汶 물이름	문
彌 두루,그칠	미
旻 가을하늘	민
悶 민망할	민
閔 성,근심할	민
玟 옥돌,옥무늬	민
珉 옥돌	민
旼 온화할	민
縛 묶을	박
潘 뜨물	반
磻 물이름	반
渤 바다이름	발
鉢 바리때	발
旁 두루,곁	방
肪 비계	방
龐 클	방
謗 헐뜯을	방
裵 성	배
帛 비단	백
筏 뗏목	벌
笵 성	범
弁 고깔	변
卞 성	변
炳 불꽃	병
昺 빛날	병
柄 자루	병
秉 잡을	병
輔 도울	보
甫 클	보
僕 종	복
蓬 쑥	봉
釜 가마	부
訃 부고	부
賻 부의	부
傅 스승	부
阜 언덕	부
剖 쪼갤	부
敷 펼	부
盆 동이	분
焚 불사를	분
噴 뿜을	분
忿 성낼	분
芬 향기로울	분
鵬 붕새	붕
毘 도울	비
匕 비수	비
譬 비유할	비
毖 삼갈	비
丕 클	비
彬 빛날	빈
泗 물이름	사
祠 사당	사
奢 사치할	사
徙 옮길	사
嗣 이을	사
撒 뿌릴	살
庠 학교	상
嗇 아낄	색
甥 생질	생
牲 희생	생
逝 갈	서
棲 깃들일	서
舒 펼	서
晳 밝을	석
錫 주석	석
奭 클	석
繕 기울	선
膳 반찬	선
璿 아름다운옥	선
璇 옥이름	선
瑄 크고둥근옥	선
卨 사람이름	설
薛 성	설
蟾 두꺼비	섬
陝 땅이름	섬
閃 번쩍할	섬
暹 해돋을	섬
燮 불꽃	섭
晟 밝을	성
醒 술깰	성
逍 거닐	소
沼 늪	소
巢 새집	소
邵 성	소
悚 두려워할	송
宋 송나라	송
碎 부술	쇄
蒐 모을	수
銖 무게이름	수
羞 부끄러울	수
隋 수나라	수
繡 수놓을	수
戍 수자리	수
粹 순수할	수
酬 술권할 	수
塾 글방	숙
淳 순박할	순
珣 옥그릇	순
筍 죽순	순
洵 참으로	순
荀 풀이름	순
瑟 큰거문고	슬
繩 노끈	승
柴 섶	시
猜 시기할	시
尸 시동	시
媤 시집	시
弑 죽일	시
湜 맑을	식
軾 수레앞턱가로나무	식
蝕 좀먹을	식
迅 빠를	신
娠 아이밸	신
瀋 물이름,즙	심
啞 벙어리	아
嶽 큰산	악
斡 돌	알
閼 막을	알
庵 암자	암
鴨 오리	압
艾 쑥	애
隘 좁을	애
埃 티끌	애
倻 땅이름	야
襄 도울,오를	양
禦 막을	어
彦 선비	언
淵 못	연
捐 버릴	연
姸 예쁠	연
衍 퍼질	연
閻 마을	염
燁 빛날	엽
瑩 밝을,귀막이옥	영
瑛 옥빛	영
盈 찰	영
芮 성	예
濊 흐릴,깊을	예
伍 대오	오
墺 물가	오
吳 성	오
沃 기름질	옥
鈺 단단한쇠	옥
甕 독	옹
擁 안을	옹
雍 화락할	옹
邕 화할,막힐	옹
訛 그릇될	와
莞 왕골	완
汪 넓을	왕
旺 성할	왕
倭 왜나라	왜
耀 빛날	요
姚 예쁠	요
夭 일찍죽을	요
茸 녹용	용
踊 뛸	용
鏞 쇠북	용
溶 질펀히흐를,녹일	용
瑢 패옥소리	용
佑 도울	우
祐 복	우
寓 붙여살	우
煜 불꽃빛날	욱
頊 삼갈	욱
郁 성할	욱
旭 해뜰	욱
昱 햇빛빛날	욱
芸 향풀	운
蔚 고을이름	울
熊 곰	웅
媛 계집	원
瑗 도리옥	원
袁 옷길	원
韋 가죽	위
魏 나라이름	위
渭 물이름	위
庾 곳집	유
喩 깨우칠	유
踰 넘을	유
楡 느릅나무	유
癒 병나을	유
兪 성,그럴	유
胤 맏아들,이을	윤
鈗 병기	윤
允 진실로	윤
垠 언덕	은
殷 은나라	은
誾 향기	은
鷹 매	응
珥 귀고리	이
姨 이모	이
怡 화할,기쁠	이
翌 다음날	익
翊 도울	익
咽 목구멍	인
鎰 스물넉냥	일
佾 춤출	일
炙 고기구울	자
滋 불을	자
疵 흠	자
雀 참새	작
盞 잔	잔
樟 녹나무	장
璋 반쪽홀	장
蔣 성씨	장
匠 장인	장
庄 전장	장
杖 지팡이	장
箸 젓가락	저
迹 자취	적
甸 경기	전
顚 넘어질	전
楨 광나무,근본	정
旌 기	정
鄭 나라	정
晶 맑을	정
汀 물가	정
呈 보일,드릴	정
禎 상서로울	정
鼎 솥	정
珽 옥홀	정
悌 공경할	제
趙 나라	조
曹 무리	조
祚 복	조
曺 성씨	조
爪 손톱	조
綜 모을	종
琮 옥홀	종
疇 밭두둑	주
廚 부엌	주
註 주낼	주
做 지을	주
埈 가파를	준
濬 깊게할	준
浚 깊을,팔	준
峻 높을	준
晙 밝을	준
准 승인할	준
駿 준마	준
祉 복	지
肢 사지	지
芝 지초	지
址 터	지
稙 올벼	직
稷 피	직
晉 나라이름	진
秦 진나라	진
叱 꾸짖을	질
窒 막을	질
斟 짐작할	짐
叉 깍지낄	차
餐 먹을	찬
燦 빛날	찬
鑽 송곳	찬
璨 옥빛날	찬
瓚 제기	찬
敞 높을	창
昶 밝을,해길	창
蔡 성,풀떨기	채
埰 채밭	채
采 풍채,캘	채
陟 오를	척
隻 외짝,새한마리	척
釧 팔찌	천
澈 물맑을	철
喆 밝을	철
瞻 볼	첨
捷 빠를	첩
楚 초나라	초
秒 초침(까끄라기묘)	초
蜀 나라이름	촉
囑 부탁할	촉
叢 떨기	총
崔 높을	최
鄒 추나라	추
椿 참죽나무	춘
黜 물리칠	출
沖 깊을	충
聚 모을	취
仄 기울	측
惻 슬퍼할	측
雉 꿩	치
侈 사치할	치
峙 언덕	치
勅 칙서	칙
鐸 방울	탁
呑 삼킬	탄
灘 여울	탄
眈 노려볼	탐
兌 기쁠,괘이름	태
台 별	태
坡 언덕	파
阪 언덕	판
牌 패	패
彭 성,땅이름	팽
鞭 채찍	편
扁 현판	편
哺 먹일	포
鮑 절인어물	포
鋪 펼,전방	포
葡 포도	포
杓 자루	표
馮 성,탈(빙)	풍
弼 도울	필
乏 다할	핍
瑕 티,흠	하
轄 다스릴,비녀장	할
函 함	함
陜 땅이름(좁을협)	합
沆 넓을	항
亢 목,별이름	항
懈 게으를	해
骸 뼈	해
杏 은행,살구	행
赫 붉을,빛날	혁
爀 빛날	혁
峴 고개	현
炫 빛날	현
鉉 솥귀	현
狹 좁을	협
瀅 맑을	형
炯 빛날	형
邢 성,나라이름	형
馨 향기	형
扈 뒤따를	호
晧 밝을	호
祜 복	호
昊 하늘	호
濠 해자,강이름	호
壕 해자,도랑	호
鎬 호경,빛날	호
皓 흴	호
泓 물깊을	홍
桓 굳셀	환
煥 빛날	환
猾 교활할	활
滉 깊을	황
晃 밝을	황
賄 뇌물	회
淮 물이름	회
后 왕후	후
熏 연기낄	훈
壎 질나팔,흙풍류	훈
薰 향풀,향내	훈
徽 아름다울	휘
烋 아름다울	휴
匈 떠들썩할,종족이름	흉
欽 공경할	흠
欠 하품	흠
憙 기뻐할	희
禧 복	희
熹 불빛성할	희
羲 사람이름	희
姬 아씨	희
嬉 즐길	희
犧 희생	희