暇 겨를	가
架 시렁	가
覺 깨달을	각
閣 누각	각
却 물리칠	각
刻 새길	각
姦 간사할	간 
簡 대쪽,간략할	간
刊 책펴낼	간
鑑 거울	감
鋼 강철	강
綱 벼리	강
介 끼일	개
槪 대개	개
蓋 덮을	개
距 떨어질	거
拒 막을	거
據 의거할	거
傑 뛰어날	걸
劍 칼	검
憩 쉴	게
激 부딪칠	격
擊 칠	격
遣 보낼	견
缺 이지러질	결
兼 겸할	겸
硬 굳을	경
傾 기울	경
竟 마침내	경
卿 벼슬	경
械 기계	계
係 맬	계
契 맺을	계
啓 열	계
系 이어맬	계
枯 마를	고
姑 시어미	고
稿 원고,볏집	고
恭 공손	공
孔 구멍	공
恐 두려울	공
貢 바칠	공
供 이바지할	공
攻 칠	공
瓜 오이	과
戈 창	과
冠 갓	관
貫 꿸	관
管 대롱	관
慣 버릇	관
鑛 쇳돌	광
怪 기이할	괴
壞 무너질	괴
較 견줄	교
巧 공교할	교
郊 들	교
矯 바로잡을	교
龜 거북	귀
構 얽을	구
拘 잡을	구
苟 진실로	구
屈 굽힐	굴
宮 집	궁
券 문서	권
拳 주먹	권
鬼 귀신	귀
菌 버섯	균
劇 심할	극
克 이길	극
斤 도끼,근	근
謹 삼갈	근
筋 힘줄	근
琴 거문고	금
錦 비단	금
禽 새	금
畿 경기	기
奇 기이할	기
企 꾀할,바랄	기
機 베틀,기계	기
紀 벼리	기
寄 부칠	기
祈 빌	기
欺 속일	기
緊 굳게얽을	긴
諾 허락할	낙
娘 아가씨	낭
耐 견딜	내
寧 편안할	녕
奴 종	노
濃 짙을	농
腦 뇌	뇌
茶 차     (차)다
檀 박달나무	단
淡 맑을	담
擔 멜	담
畓 논	답
黨 무리	당
糖 엿	당
臺 대	대
帶 띠	대
貸 빌릴	대
途 길	도
倒 넘어질	도
逃 달아날	도
盜 도둑	도
跳 뛸	도
稻 벼	도
禱 빌	도
導 인도할	도
督 감독할	독
毒 독	독
敦 도타울	돈
豚 돼지	돈
突 갑자기,부딪칠	돌
銅 구리	동
鈍 무딜	둔
羅 벌릴,비단	라
絡 맥락,얽힐	락
蘭 난초	란
亂 어지러울	란
藍 쪽	람
糧 양식	량
麗 고울	려
慮 생각	려
勵 힘쓸	려
憐 불쌍할	련
戀 사모할	련
鍊 쇠불릴	련
蓮 연꽃	련
聯 잇닿을	련
劣 못할	렬
裂 찢을	렬
嶺 고개	령
零 떨어질	령
鹿 사슴	록
弄 희롱	롱
雷 우레	뢰
了 마칠	료
龍 용	룡
樓 다락	루
累 여러,묶을	루
輪 바퀴	륜
率 거느릴솔,헤아릴	률
栗 밤	률
陵 언덕	릉
離 떠날	리
履 밟을,신	리
梨 배	리
裏 속 	리
吏 아전	리
隣 이웃	린
臨 임할	림
麻 삼	마
妄 망령될	망
梅 매화	매
脈 맥	맥
孟 맏	맹
盟 맹세	맹
盲 소경	맹
銘 새길	명
冥 어두울	명
謀 꾀할	모
貌 모양	모
募 모을	모
模 법,본뜰	모
慕 사모할	모
某 아무	모
矛 창	모
沐 목욕할	목
睦 화목할	목
夢 꿈	몽
蒙 어릴	몽
廟 사당	묘
苗 싹	묘
貿 무역할	무
黙 잠잠할	묵
迷 미혹할	미
微 작을	미
敏 재빠를	민
博 넓을	박
薄 엷을	박
拍 칠	박
返 돌아올	반
般 일반,돌	반
髮 터럭	발
芳 꽃다울	방
邦 나라이름	방
妨 해로울	방
輩 무리	배
排 물리칠	배
培 북돋을	배
配 짝	배
繁 번성할	번
汎 뜰	범
範 법	범
壁 벽	벽
邊 가	변
辯 말잘할	변
辨 분별할	변
竝 나란히할	병
補 기울,도울	보
普 넓을	보
譜 족보	보
複 겹칠	복
腹 배	복
卜 점	복
峰 봉우리	봉
府 관청	부 
副 버금	부
付 부칠	부
負 질	부
粉 가루	분
奔 달릴	분
奮 떨칠	분
憤 분할	분
紛 어지러울	분
拂 떨	불
弗 아니	불
婢 계집종	비
卑 낮을	비
碑 비석	비
批 비평할	비
肥 살찔	비
妃 왕비,짝	비
賓 손님	빈
詞 말	사
辭 말씀	사
司 맡을	사
捨 버릴	사
詐 속일	사
斯 이	사
祀 제사	사
賜 줄	사
削 깎을	삭
朔 초하루	삭
森 빽빽할	삼
償 갚을	상
祥 상서로울	상
像 형상	상
索 찾을	색
署 관청	서
庶 여러	서
恕 용서할	서
徐 천천히	서
析 가를	석
釋 풀	석
宣 베풀	선
涉 건널	섭
蔬 나물	소
昭 밝을	소
訴 하소연할	소
屬 무리,붙일	속
頌 기릴	송
訟 송사할	송
誦 욀	송
刷 인쇄할	쇄
衰 쇠할	쇠
囚 가둘	수
需 구할	수
殊 다를	수
輸 보낼	수
遂 이룰,드디어	수
帥 장수	수
肅 엄숙할	숙
熟 익을	숙
盾 방패	순
巡 순행할	순
旬 열흘	순
述 지을	술
襲 엄습할	습
濕 젖을	습
侍 모실	시
矢 화살	시
飾 꾸밀	식
愼 삼갈	신
審 살필	심
雙 쌍	쌍
雅 바를	아
亞 버금	아
牙 어금니	아
餓 주릴	아
岸 언덕	안
壓 누를	압
涯 물가	애
額 이마	액
液 진액	액
躍 뛸	약
樣 모양	양
楊 버들	양
壤 흙	양
輿 수레	여
役 부릴	역
驛 역마	역
延 끌	연
鉛 납	연
沿 물따라내려갈	연
燃 불탈	연
緣 인연	연
宴 잔치	연
演 펼,멀리흐를	연
染 물들일	염
鹽 소금	염
映 비칠	영
泳 헤엄칠	영
銳 날카로울	예
豫 미리	예
汚 더러울	오
遙 멀,거닐	요
辱 욕될	욕
慾 욕심	욕
羽 깃	우
優 넉넉할	우
愚 어리석을	우
郵 우편	우
援 구원할	원
越 넘을	월
圍 둘레	위
委 맡길	위
胃 밥통	위
慰 위로할	위
衛 지킬	위
誘 꾈	유
裕 넉넉할	유
悠 멀	유
維 벼리	유
隱 숨을	은
儀 거동	의
宜 마땅	의
疑 의심	의
刃 칼날	인
姻 혼인할	인
逸 편안	일
賃 품팔이	임
姿 맵시	자
雌 암컷	자
資 재물	자
殘 남을	잔
潛 잠길	잠
雜 섞일	잡
獎 권면할	장
裝 꾸밀	장
障 막을	장
張 베풀	장
丈 어른	장
臟 오장	장
帳 휘장	장
抵 거스를,막을	저
底 밑	저
績 길쌈,공	적
賊 도둑	적
籍 문서	적
跡 발자취	적
蹟 사적,자취	적
折 꺾을	절
占 점칠	점
整 가지런할	정
程 길,법	정
訂 바로잡을	정
亭 정자	정
廷 조정	정
征 칠,갈	정
齊 가지런할	제
濟 건널	제
提 끌	제
堤 둑	제
際 사이,때	제
照 비칠	조
條 조목,가지	조
弔 조상할	조
租 조세	조
潮 조수	조
組 짤	조
拙 못날	졸
佐 도울	좌
座 자리	좌
株 그루	주
柱 기둥	주
周 두루	주
舟 배	주
準 법도	준
遵 좇을	준
俊 준걸	준
症 증세	증
誌 기록할	지
池 못	지
織 짤	직
陳 늘어놓을	진
珍 보배	진
鎭 진압할	진
陣 진칠	진
姪 조카	질
秩 차례	질
差 어긋날	차
錯 섞일	착
讚 기릴	찬
贊 도울	찬
倉 곳집	창
債 빚	채
策 꾀	책
戚 겨레	척
拓 넓힐	척
踐 밟을	천
賤 천할	천
哲 밝을	철
添 더할	첨
尖 뾰족할	첨
妾 첩	첩 
廳 청사	청
替 바꿀	체
超 넘을	초
礎 주춧돌	초
促 재촉할	촉
總 거느릴,다	총
聰 귀밝을	총
銃 총	총
畜 기를	축
蓄 모을,저축할	축
築 쌓을	축
縮 줄어질	축
醉 술취할	취
趣 취미,뜻	취
側 곁	측
測 헤아릴	측
値 값,만날	치
置 둘	치
恥 부끄러울	치
稚 어릴	치
沈 잠길	침
寢 잠잘	침
浸 적실	침
侵 침노할	침
稱 일컬을	칭
妥 평온할	타
濯 씻을	탁
濁 흐릴	탁
歎 탄식할	탄
彈 탄알	탄
奪 빼앗을	탈
貪 탐할	탐
塔 탑	탑
湯 끓을	탕
怠 게으를	태
態 모양	태
擇 가릴	택
澤 못	택
兎 토끼	토
吐 토할	토
鬪 싸울	투
透 통할	투
派 물갈래	파
播 뿌릴	파
版 판목	판
販 팔	판
編 엮을	편
評 평론할	평
肺 허파	폐
砲 대포	포
浦 물가	포
捕 잡을	포
胞 태보	포
爆 터질	폭
幅 폭	폭
標 표할	표
被 입을	피
避 피할	피
畢 마칠	필
荷 연꽃,짐	하
割 벨	할
咸 다	함
巷 거리	항
抗 겨룰	항
項 목	항
航 배	항
港 항구	항
核 씨	핵
享 누릴	향
響 소리	향
獻 드릴	헌
憲 법	헌
險 험할	험
革 가죽	혁
顯 나타날	현
絃 줄	현
弦 활시위	현
亨 형통할	형
護 보호할	호
昏 저물	혼
弘 클	홍
禾 벼	화
禍 재앙	화
確 굳을	확
擴 넓힐	확
環 고리	환
換 바꿀	환
丸 알	환
況 하물며	황
悔 뉘우칠	회
灰 재	회
劃 그을	획
揮 휘두를	휘