街 거리	가
假 거짓	가
佳 아름다울	가
干 방패	간
看 볼	간
甲 껍질,갑옷	갑
降 내릴	강
講 익힐	강
康 편안할	강
更 다시	갱
巨 클	거
檢 검사할	검
儉 검소할	검
潔 깨끗할	결
警 경계할	경
慶 경사	경
耕 밭갈	경
境 지경	경
經 지날,글	경
庚 천간,별	경
戒 경계할	계
溪 시내	계
繼 이을	계
癸 천간,북방	계
庫 곳집	고
谷 골	곡
官 벼슬	관
究 궁구할	구
句 글귀	구
群 무리	군
弓 활	궁
權 권세	권
歸 돌아갈	귀
均 고를	균
禁 금할	금
及 미칠	급
起 일어날	기
暖 따뜻할 	난
難 어려울	난
納 들일	납
乃 이에	내
怒 성낼	노
努 힘쓸	노
斷 끊을	단
丹 붉을	단
單 홑	단
達 통달할	달
隊 무리	대
徒 무리	도
斗 말	두
豆 콩	두
得 얻을	득
燈 등잔	등
略 간략할	략
連 이을	련
烈 매울,뜨거울	렬
列 벌일	렬
錄 기록할	록
論 논할	론
倫 인륜	륜
莫 없을	막
滿 찰	만
忘 잊을	망
妙 묘할	묘
卯 토끼	묘
戊 천간,별	무
務 힘쓸	무
尾 꼬리	미
密 빽빽할	밀
飯 밥	반
防 막을	방
房 방	방
訪 찾을	방
背 등	배
拜 절	배
罰 벌할	벌
伐 칠	벌
丙 남녘	병
寶 보배	보
保 지킬	보
伏 엎드릴	복
復 돌아올	복
否 아닐	부
佛 부처	불
飛 날	비
悲 슬플	비
非 아닐	비
巳 뱀,지지	사
絲 실	사
寺 절	사
舍 집	사
散 흩어질	산
殺 죽일	살
狀 모양	상
想 생각	상
床 평상   	상
舌 혀	설
細 가늘	세
稅 세금	세
掃 쓸	소
笑 웃음	소
素 흴,본디	소
續 이을	속
俗 풍속	속
松 소나무	송
收 거둘	수
愁 근심	수
修 닦을	수
受 받을	수
純 순수할	순
戌 개,지지	술
拾 주울	습
承 이을	승
息 숨쉴	식
辛 매울	신
申 펼,지지	신
若 같을,만약	약
與 더불,줄	여
逆 거스를	역
硏 갈	연
煙 연기	연
營 경영할	영
榮 영화	영
誤 그릇될	오
謠 노래	요
容 얼굴	용
遇 만날	우
圓 둥글	원
員 인원	원
危 위태할	위
遺 남길	유
酉 닭,지지	유
乳 젖	유
乙 새	을
陰 그늘	음
應 응할	응
依 의지할	의
異 다를	이
貳 두  	이
益 더할	익
引 끌	인
印 도장	인
寅 범	인
認 알	인
壹 한  	일
壬 천간,북방	임
壯 씩씩할	장
適 맞을	적
專 오로지	전
絶 끊을	절
點 점	점
接 이을	접
井 우물	정
丁 장정,천간	정
除 덜	제
制 마를,법도	제
製 지을	제
兆 조	조
造 지을	조
尊 높을	존
宗 마루	종
走 달릴	주
朱 붉을	주
衆 무리	중
持 가질	지
指 손가락	지
職 벼슬,직분	직
辰 별,지지	진
創 비롯할	창
冊 책	책
聽 들을	청
請 청할	청
丑 소	축
取 가질	취
治 다스릴	치
針 바늘,침	침
快 쾌할	쾌
脫 벗을	탈
探 찾을	탐
討 칠	토
破 깨뜨릴	파
判 판단할	판
片 조각	편
布 베,펼	포
暴 사나울 (폭)포
包 쌀	포
票 표,쪽지	표
亥 돼지	해
解 풀	해
鄕 시골,마을	향
虛 빌	허
驗 시험	험
賢 어질	현
呼 부를	호
戶 지게문	호
貨 재화	화
候 기후	후
吸 숨들이쉴	흡
興 일어날	흥
希 바랄	희