車 수레	거
巾 수건	건
古 예	고
工 장인	공
今 이제	금
同 한가지	동
力 힘	력
立 설	립
末 끝	말
文 글월	문
方 모	방
本 근본	본
夫 지아비	부
不 아니	불
士 선비	사
夕 저녁	석
世 세상	세
少 적을	소
食 먹을	식
央 가운데	앙
王 임금	왕
位 자리	위
衣 옷	의
字 글자	자
自 스스로	자
正 바를	정
主 주인	주
寸 마디	촌
向 향할	향
休 쉴	휴